8
#######
# .   #
#     #
# # # #
# # # #
# $@  #
#     #
#######